1111111111111
1001000T000C1
100100000T001
1000011111001
1P0011E000001
1111111111111
